6 6 0 0 5 5
5 3 3 2 4 4 
3 3 4 4 2 4
1 4 1 2 4 2
3 4 1 3 2 3
4 3 2 4 4 4
2 3 5 2 3 0 